25 20
####     #     ##   #
#   #   # #    # #  #
#   #  #####   #  # #
####  #     #  #   ##
 ...   .....   ....
.      .       .   .
.  ..  ...     ....
.   .  .       .   .
 ...   .....   .    .
######################
#<@..........c.x....w#
#...................x#
#..........S.....3...#
#................4...#
#w........S...3......#
#.............4....h.#
#..........S.....3..w#
#x.............x.4...#
#w.......b.........k.#
######################
