25 20
####     #     ##   #
#   #   # #    # #  #
#   #  #####   #  # #
####  #     #  #   ##
 ...   .....   ....
.      .       .   .
.  ..  ...     ....
.   .  .       .   .
 ...   .....   .    .
############ß#########
#<...........c.x....w#
#...................x#
#..........S.....4...#
#w...............3...ß
#t........S...4......#
#.............3....h.#
#..........S.....4..w#
#x.............x.3...#
#w..€....b.........k.#
####ß##########ß######