25 20






#############
#...........#    ########
#...........######......#
#.......................#
#...........######......#
#...........#    #......#
#...........#    #......#
#.....@.....#    #......#
######<######    ########





