25 20






#############
#...........#    ########
#..c........######......#
#....................C..#
#...........######......#
#...........#    #......#
#...........#    #......#
#<..........#    #......#
#############    ########





